AABBC BADBB
BBBBB BCBDD
AABCB BBDAA
BBBBB BCBDD
AABCB BBDAA
BBBBB BCBDD
AABCB BBDAA
BBBBB BCBDD
AABCB BBDAA
BBBBB BCBDD
AABCB BBDAE